{
  "levelName": "Начало кошмара",
  "mapSize": 10,
  "map": [
    [1, 1, 1, 1, 1, 1, 1, 1, 1, 1],
    [1, 0, 0, 0, 0, 0, 0, 0, 0, 1],
    [1, 0, 1, 1, 0, 1, 1, 1, 0, 1],
    [1, 0, 1, 0, 0, 0, 0, 1, 0, 1],
    [1, 0, 0, 0, 1, 1, 0, 0, 0, 1],
    [1, 0, 1, 0, 0, 1, 1, 1, 0, 1],
    [1, 0, 1, 1, 0, 0, 0, 0, 0, 1],
    [1, 0, 0, 0, 0, 1, 1, 1, 0, 1],
    [1, 0, 0, 0, 0, 0, 0, 0, 0, 1],
    [1, 1, 1, 1, 1, 1, 1, 1, 1, 1]
  ],
  "spawnPoint": { "x": 1.5, "z": 1.5 }
}
